10 10
##########
#........#
#.*..O...#
#........#
#...##...#
#...##...#
#.@...O..#
#.......*#
#........#
##########